################################################################
###############################....#############################
####.......####......##########....#############################
####.......####......##########....#############################
####.......####......##########....#############################
####.......####.........#######....####.........################
########.####...........#######....####.........################
##......................#######.................################
##......#.###...........#######......................###########
##......#.###...........#######.........................########
##......#.###.........#########.........................########
##......#.###.........############........................######
##......#.###.........############......#.................######
##.............#####.#############......#.................######
##...................##############.###.#.................######
##...................##############.###.#.................######
##...................##############.###.#.................######
######..................###########.###.#.................######
######..........................###.###.........####....########
######..........................###.#####.......################
#################...............###.#####.......################
#################...................#####.......################
############....................#########.......################
##...........####..................######.......################
#..##############..................#######......################
#.################....#............#######......################
#.################....#............#######......################
#.################....#........##########............###########
#.......########......#........##########............###########
#.....#.########...............##########.#..........###########
#.....#.########...............##########.#..........###########
#.......########.............############.#..........###########
##....##########................#########.#######.......########
##....######....................#########.########......########
##....######....................#########.########......########
##....######....................#########.########......########
##....######....................#########.########...........###
############....................#########.########...........###
###########..................############.########...........###
###########..................############.###................###
###########........#.........############.###................###
###....####........###.........##########.###................###
###............................##########.###................###
###....####........###.........########...###.........##.#######
###....####........###.........########.#####.........##.#######
###....####....#######.........########.#####.........##.#######
###....####......#####.........########.#####.........##.#######
###....####......######################.########.......#.#######
###....####......#########......#######.########.......#.#######
###......................#......#######.########.......#.#######
###....#####.............#.......####.....######.......#.#######
############.....................####.....######.......#.#######
############.............#.......####.....######.......#.#######
############.............####.............#####........#.#######
############.............####.............#####........#.#######
############.............####.............#####........#.#######
############..........#######.............#####.########.#######
############..........#######........##########..........#######
#############################........###########################
###############################......###########################
###############################......###########################
################################################################
################################################################
################################################################
