####################################################################################################
####################################################......##########################################
####################################################......##########################################
####################################################......##########################################
####################################################......##########...........#####################
####################################################......##########...........#####################
####################################################......##########.........................#######
####################################################......##########...........#############.#######
####################################################......##########...........#############.#######
###################################################.......##########...........#############.#######
##################..........#######################.......##########...........#############.#######
#############...............#######################.###.############...........#############.#######
#############...............#######################.###.############...........#############.#######
#############...............#######################.###.####################################.#######
#############...............#######################.###.#..........########...##############.#######
#############...............#######################.###.#.##................#.##############.#######
#############...........#######......##############.###.#.##................#.##############.#######
#############...........#######......##############.###.#.##................#.##############.#######
#############...........#######............########.###.#.##................#................#######
#############...........#######......#####.########.###.#.##................########################
#############...........#######......#####.########.###.#.##................########################
########................#######......#####.########.###.#.##.......##.#####.########################
########.####...........#######......#####.########.###.#.########.##.....#.########################
########.######################......#####.########.###.#.###############.#.########################
########.######################......#####.#..............###############...########################
########.##.###################......#####.#.######.###.############################################
########..............#########......#####.#.######.###.###################............#############
##########............#########......#####.#.######.###.######............#............#############
##########............#########......#####.#.#.................##########..............#############
##########............#########......#####.#.#.####.###....##..##########..............#############
##########............##########.#########.#.#.####.######.##..##########..............#############
##########............##########.#########.....................##########..............#############
##########............##########.###########......########....###########..............#############
##########............##########.###########.####.#######################.......................####
##########............##########.###########.####.###########...........#.......................####
##########............##########.######..###.####................................###............####
##########.###.#################.######......################...........#........###............####
##########.###.#################.######.####.###........#####...........#........###............####
##########.###.#################.######.####.###........#####...........#........###............####
##########.###.########..........######.####.###........#####.................##.###............####
#######.................................................#####.................##.###............####
#######.##.###.###########.############.####.###........#####.................##.###............####
#######.##.###.###########.############.####.###........#####.................##.###################
#######.##.###.###########.############.####.###........#####....................###################
#######.##.###.###########.##########........########################............###################
#######........###########.##########...........############..................##.###################
##########.###############.##########.......###.############.########.........##.###################
##########.###############......#####........##.############.########.........##.###################
##########...................................##.############.########.........##.###################
#############################...................############.########.........##.###################
#############################.#.####........################.########.........##.###################
#############################.#.####........################.###################.###################
#########################.....#.####........################.###################.###################
#########################.##..#.######.####.################.###################.###################
#########################.........####.####.################.##################..###################
############################..#.#.####.####.###############..##################.####################
############################..#.#.####.####.###############.###################.####################
############################..#.#......####.###############.###################.####################
############################..#.###########.###.............###################.####################
#########################..........########.###.###############################.####################
#########################..........########.###.###############################.####################
#######################.....................##..........#######################.####################
####################...............###########..........#######################.####################
####################.##............###########..........#######################.####################
############.......................###########..........#######################.#................###
############........................##########..........#######################.#.##############.###
############........................##########..........###################......................###
############......................#.##########..........###################.###.#.##################
############......................#.##################.####################.........################
############......................#.##################.########################...#.################
############........................##################.############################.################
############......................#.##################.############################.################
############......................#.##################.############################.################
############............#.#####.###.......###########...#######################...........##########
############............#.#####.####......###########...#######################...........##########
#########################.#####.####......###########...#######################...........##########
########################.........###......###########...#######################...........##########
########################.######...........#############.#######################...........##########
########################.######.####......#############.#######################...........##########
########################.######.####......#############.#######################...........##########
########################.######.####......#############.#######################...........##########
######################......###.####......#############.#######################...........##########
######################......###.####......#############.#######################...........##########
######################......###.#####.###...............#######################...........##########
######################......###.#####.###..####################################...........##########
######################......###.#####.##############################################################
######################......###.#####.##############################################################
###############################.#####.##############################################################
###############################.......##############################################################
####################################################################################################
####################################################################################################
####################################################################################################
####################################################################################################
####################################################################################################
####################################################################################################
####################################################################################################
####################################################################################################
####################################################################################################
####################################################################################################
####################################################################################################
