####################################################################################################
####################################################################################################
####################################################################################################
###############################........#############################################################
#######......##################........#############################################################
#######......##################........#############################################################
#######......##################........####################################.........################
#######......##################........####################################.........################
#######......##################........####################################.........################
#######......##################........##################...........................################
#######......##########......##........##################.#################.........################
#######......................##........##################.#################.............############
#######......##########......######.#.###################.#################.............############
#######......##########......######.#.###################.#################.............############
#######......##########......######.#.#############.......#################.............############
#######......##########......######.#....##########.......#################.............############
#######......##########.......#####.#..#.##########.......#################.............############
#######......#####.......................##########.......################..............############
##################............#####.#..############.........##############.......................###
##################............#####.#....##########.......#........#######.......................###
##################............#####.##.#..........######...........#######.......................###
##################............#####.##.#..........######.#################.......................###
##################............#####.##.#..........######.#################.......................###
##################............#####.##.#..........######.#################.......................###
##################............#####.##.#..........#####........###########.......................###
##############......####.####.#####.##.#..........#####........###################.##............###
##############......####.......####.##.#..........#####........###################.##............###
##############......####.......####.##.#.......................###################.##............###
##############......####.......####.##.#..........#####........####...........####.##............###
#...................####.......####.##.#..........#####...............#######.####.###########.#####
#.....########.................####.##........#########........####.#.#######.####.###########.#####
#####.########.................####.##........#########........####...#######.####.###########.#####
#####.########.................####.##........#########........######................#########.#####
#####.########.................####.##........#########........######.######.........#########.#####
#####.########............#########.##........#########........######.######.........#########.#####
#####.########............#########.##........###..........##########................##.........####
#####.########......##.#.##########.##............................###................##.........####
#####.###......#######.#.##########.#########.....................###................##.........####
#####.###......#######.#.##########.#########.....................###................##.........####
#####.###......#######.#.##########.#########.....................###.......###.#######.........####
#####.###......#######.#.##########.#########.....................###.......###########.........####
#####.###......#######.#.##########.#########.....................###.......###########.........####
#####.###......#######.........####.########......................###.......###########.........####
#####..........#########..........#.####...................##########.......###########.........####
#########......###############.##.#.####..............#################################.........####
#########......###############.##.#.####..............#################################.############
#########......###############.##.#.####..............##########........###############.############
#########......###############......####...........#############........###############.############
#########......##################.######...........#############..................#####.############
#################################.######...........#############..................#####.############
#################################.###############.##############..................#####.############
#################################.###############.##############..................#####....#########
#################################.###############.##############..................######...#########
#################################.###############.##############..................######.###########
#########################......##.###############.##############..................######.###########
#########################......##.###############.##############..................######.###########
#########################......##.###############.##############............#..........#.###########
#########################......##.#####.........#.#########.................#..........#.###########
#########################......##.#####.........#.#########.................#..........#.###########
#########################......##.#####.............#######.................#..........#.###########
#########################.........#####.........#.#.#######...........#######..........#.###########
###....................##......##.#####.........#.#.#######...........#######..................#####
###....................##......##.#####.........#.#.#######..................#######...........#####
###....................##......##.#####.........#.#.#######...........######.#.................#####
###....................##.####..................#.#.#######...........######.#.................#####
###....................##.##............#########...#######.......##########.#.................#####
###....................##.##............###################.......##########.#.................#####
###.......................##............##################........##########.#.................#####
######...............................................#####........##########.#................######
######.......####.###.######.........................#####.###############....................######
######.......####.##########.........................#####..........######....................######
######.......####.##########.........................##############.######....................######
######.......####.##########.........................##############.######....................######
######.......####.##########.........................##############.######...........#........######
######.......####.######.............................##############.######...........#........######
#################.######...............######........##############.######...........#........######
#################.######............##########.####################.######...........#........######
#################.######............#######...........#############.######...........###############
#################.#.................#######...........#############.################################
#######.......###.#.####............#######...........#############.################################
#######.............................#######............############.################################
#######...........#.................#######............############.################################
#######.......##..#.................#######............############.################################
#######.......##..#........###.....########............############.################################
#######.......#####........################.............###########.################################
#######.......#####........################.............###########.################################
#######.......#####........################.............##............##############################
#######.......#####........####################.........##............##############################
#######.......#####........####################.........##............##############################
#######.......#####........####################.........##............##############################
###################........####################........###............##############################
#################################################.###.####............##############################
#################################################.###.####............##############################
#################################################.....####............##############################
##########################################################............##############################
####################################################################################################
####################################################################################################
####################################################################################################
####################################################################################################
####################################################################################################
