####################################################################################################
####################################################################################################
####################################################################################################
####################################################################################################
####################################################################################################
####################################################################################################
####################################################################################################
####################################################################################################
####################################################################################################
####################################################################################################
##################.......########################################.......############################
##################.......#######################............#####.......############################
##################.......#######################........................########........############
##################.......#########################......###.#####.......####............############
##################.......#########################......###.#####.......####............############
#####.......######.......#########################......###.#####.......####............############
#####.......######.......#########################......###.#####.......####............############
#####...........##........#############......#####......###.#####.......####............############
##..............##........#############......#####......###.#####.......####............############
##..............##........#############......#####......###.#####.......####............############
##..............##........#############......#####.............###......####............############
##..............##........#############......#####.............###......####............############
##..............##........#############......#####.............###......................############
##..............##........##################.####..............###......................############
##..............##........##################.##.........................................############
##..............##........##################.##......................................###############
##..............#.........##################.####.#...........................######.###############
#########................###################..###.#...........................######.......#########
#########................####################.....#...........................######.......#########
##############...........###......#################...........................#######......#########
#############............#........###########...........................###.#########......#########
#############............#........###########......######...............###.#..............#########
#############...........##........###########......#############........###.#.#######......#########
#############...........##................###......#############..#########...#######......#########
#############...........##........#######.###......#############..##########..#######......#########
#############...........##........#####...###......#############..##########..#######......#########
#############...........##........#####.#####......#############..##########..#######......#########
#############...........##........#####.#####......#############..##########..#########.############
##############......######........#####.#####......#############..##########..#########.############
################......####........###.......#......#############..##########..#########.############
#####################.####........###.......######.#####.....###..##########..#########.############
#####################.####........###.......######..####......#........#####..#########.############
#####################.#######.#######.......#######.########..#........#####..#########.############
#####################.#######.#######.......#######.########..#........#####..#########.############
#####################.#######.......#.......#######.########..............##..#########.############
#####################.######........#.......#######.########.##...........##..#########.############
###################...######.#......#.......#######.########.##........#####..#########.############
###################.########.#......#.......#######.########.##........#####..#########.############
###################.########.#........#####.#######.########.##........#####..#########.############
###################.########.#......###........####.######...##..................######.############
###..........######.########.##########........####.######.......................######.############
###..........######.########.##########........####.###########...............####.......###########
###..........######.########.##########...................................##..####.......###########
###.................########.##########.............#############.##########..####.......###########
###..........######..........##########........##################.##########..####.......###########
###..........######.........###########........##################.##########..####.......###########
###..........######.........###########...........................##########..###............#######
###..........######.........###########........#############################..###............#######
#............######.............#######........#############################..###............#######
#............######.............#######........#############################..###............#######
#............######.............#######.................####################..###............#######
#............##########.........###########.###.........####################..###............#######
#......################.........#######.................####..............##..#####.################
#......################.........#######.................####..........###.......###.###......#######
#......################################..................####.........###.......###.###......#######
#......################################..................####.........###.......###.###......#######
#######################################.................#####.........###.......###.###......#######
#######################################.................#####.........###.......###.###......#######
#######################################........######.#######.........###.......###..........#######
###########################################.........#.###.......#########.......#######......#######
############################################........#.###.......#########.......#######......#######
##################.........#################............#.......#########.......####################
##################.........#################............#.......#########.......####################
##################............#####.....................#.......#########........###################
##################.........##..####.....................#.......#########..........#################
##################.........###.####.....................#.......##################.#################
##################.........###.####.....................#.......##################.#################
##################.........##..####....................................###########.#################
##################.....................................................###########.#################
##################.................................####................###########..################
##################.................................####................############.################
#########################..........................####................############.################
#########################..........#####...........####................############.################
#########################..........#####...........................################.################
######.......#####.................#####...........................################.################
######.......#####................#########.####...................#############.........###########
######.......#####................##############........########################.........###########
######.......#####................##############........###############..................###########
######.......#####.........#####################........###############..................###########
######.......#####.........#####################........###############..................###########
######.......#####.........#####################........###############..................###########
######.......#####.........#####################........###############..................###########
######.......#####.........############################################..................###########
######.......#####.........############################################..................###########
#######.##########.........#########################################################################
#######.###############.############################################################################
#######.###############.############################################################################
#######.###############.############################################################################
#######.................############################################################################
####################################################################################################
