####################################################################################################
#########............#################.........#######.......######......###########.###############
#########....................#########.........#######.......######.####.................###########
#########............#######.#########.........#######.......######.#########............###########
#########............#######.#########.........#######.......######.#########............###########
#########............#######.#########.........#######.......######.#########.................######
#########..............#####.#########.........#######...............###......................######
#########..............#####.#########.........#######...............###.####.................######
################.......#####.##########.##........####...............###.####.................######
################.......#####.##########.##........####...............###.#############........######
################..................................#######............###.#############........######
################.......################.##........#######............###.#############........######
################.......########...........................##############.###########################
###############################.#######.##........######################.###########################
##################............#...................######################.###########################
##################............#########...........######################.###########################
##################............#########.........########################.###########################
##################............#######...........#####################........#######################
##################.................##...........#####################........#######################
##################.................##...........#####################........###......##############
##################.................##...........#####################........###......##############
##################.................##...........############...................#......##############
#####...................##......................############...................#......##############
#####.########..................................############..........................##############
#####.########...........#...................###############...................#......##############
#####....................#...................###############...................#......##############
#############...........##...................###############...................#####################
#############...........##..............####################...................########........#####
#############...........................####################..........#........................#####
##############..........####............####################..........#...............#........#####
##############..........####............#####################.........#...............#........#####
##############.#######.#####............######################........#####...........#........#####
##############.#######.#####............###################################...........#........#####
##############.#######.#####..##........###################################...........#........#####
##############.#######.#####..#######.########################.......##################........#####
####...................#####..#######.########################.......##################........#####
####........#########################.#######...........######.......##################........#####
####........##############............#######........................###############################
####........##############.######.......#####...........######.......###############################
####........##############.######.#####.#####...........######.......###############################
####........##############.######.###...................######............##########################
####........##############.######.###...................######............##########################
####........##############.#####..###...................######............########......############
####.......###############.#####.####...................######............#######.......############
####.......###############.#####.####.....................####..........................############
####.......###############.#####.####...................#.########........########......############
####.......###############.......##..####.......##.#..#.#.########################......############
##########.#####################.....####.......##.#......#####........###########......############
#..........#####################.###.................##.........######.###########......############
#.########.#####################.########............##.........######.###########......############
#.########.#####################.##################..##.........######.###########......############
#.########.#####################.##.......#######....##.........######.#############################
#.########.###################........###.#######....##...........####.#############################
#.########.###################........###.#########.###................########........#############
#.########.###############............###.#########.................###########.............########
#.########.###############..................................................................########
#.####............########................................#.##......###########.............########
#.####.................#..................................#.##......###########.............########
#.####.................#.#............####.######.#.####..#.##......###########.............########
#.###..................#..............####.######.#.####..#.###################.............########
#......................###............####.######.#.####..#.########################################
#####..................###............####.######.#.####..#.########################################
#####..................###............####.######.#.####..#.########################################
#####.............................########.######.#.####..#.########################################
#####..................########..#########.###......####..#.########################################
############...........########..#########.###.##.#.####..#.########################################
############...........########..#########.###.##.#.####..#.########################################
############..........#######.......................####..#.########################################
############..........#######.#..#########.###.##.######.....###############...........#############
############..........#######......#######.###.##.######..#...##########...............#############
############..........#######......#######.###....####........##########...............#############
#######.............#########......#######.#####..####........##########...............#############
#######.............#########......#######.#####..####....................................##########
#######.............#########......#######.#####..####........##########..................##########
#######.............#########......#######.#####..####........######......................##########
#######.............#########...............####..####........######..##..................##########
#######.............#########......#######..###...............#######.##..................##########
######..............#########......#######....................#######.##..................##########
######..............#########......#######.####...............#######.###.##..............##########
######.#............#########..............####........#..###.#######..........#..........##########
######.#...........#########.......############................................#..........##########
######.#...........######..............................#.##.#..................#####################
######.##################.........#####......##..........##.##########................##############
######.##################....................####.######.##.##########.....................#########
######.##################.........#####......####...........##########.....................#########
###...............................#####......###########.##.##########.....................#########
###.##.....##############.........#####......###########....##########.....................#########
###.######.##############.........##########.##############.###############................#########
###.######.##############.........##########.##############.###################............#########
###.######.##############.........##########.##############.###################............#########
###.######.##############....................#######..#####.####################...........#########
###........##################.######################..#####.########################################
#############################.######################........########################################
#############################.#######################.##############################################
#############################.#######################.##############################################
#############################.#######################.##############################################
#############################.#################.......##############################################
#############################...................####################################################
####################################################################################################
####################################################################################################
