################################################################
################################################################
###################################.....########################
###################################.........####################
###################################.........####################
###################################.........#####....###########
###################################.........#####....###########
###################################.........#####....###########
###################################.........#####....###########
###################..........########.......#####....###########
###################................##.......#####....###########
###################.........................#####....###########
###################................##.......#####....###########
###################................##############....###########
###################................###############.#############
##############.....................###############.#############
######....####.....................####......#####.#############
######....####.....................####.####.#####.#############
######.............................####.####.#####.#############
######.............................####.##.........#############
######.........................########.##.#.###################
######.........................########.##.#.###################
########.......................########.##.#.#####......########
########...........................####......#####......########
########.............................#####...#####......########
########...........###...............#####......##......########
###########.............................................########
###########........######...................##..........########
###########.#############............##.....##...........#######
###########.#############............##..#.###...........#######
###########.#############............##..#.###...........#######
###########.#############............##..#.###...........#######
###########.#############................................#######
######....#.##....##########........###..#.###...........#######
######....#.##......................######.###...........#######
######......#.....#######..##.############.###.....#############
######....###.....#######..##.############.........#############
######....##..###########..##.################.....#############
######....##.############...........##########.#################
######..........##########.##.......##########.#################
######..........##########............########.#################
######..........##############......#.########.#################
##########......###.................#.########.#################
###################.##########......#.########.#################
###################.##########......#.########.#################
###################.#################.########.#################
###################.#################.########.#################
###################.#################.########.#################
###################.#################.########.#################
###################.##.........######.########......############
###################.##.........######.########......############
###################.##.........###.....#######......############
###################.##.........###....########......############
########............##.........###..................############
########........######.........###....########......############
########........######........####....########......############
########........######........####....########......############
########........###########.######....########......############
########................###.######....##########################
########........#######.###.######....##########################
########........#######.###.######....##########################
#######################.....####################################
################################################################
################################################################
