####################################################################################################
###...........######################################################################################
#.....................#################################............#################################
#.#...................###############################..............#################################
#.#...................###############################..............##########......#################
#.....................###############################..............##########......#################
#.....................########################......................#########...........############
##....................########################.######...............#########..................#####
##......................######################.######...............#########..................#####
##......................######################.######...............#########..................#####
##......................######################.######...............#######....................#####
##......................######################.######.....................#....................#####
##.##...................######################.####.......................#....................#####
##.##...................######################.####.#.....................#....................#####
##.##...................######################.####.###########...........#....................#####
##.##...................######################.####...........#...........#....................#####
##.##...................######################.#############..............#####.............########
##.############.........######################.#############..............######............########
##.############.........######################.#############.#............######............########
##.##############.############################.#############.#............######.............#######
##.##############.############################.#############.#.#.###############............########
##.##############.#########################..........#######.#.#.###############............########
##.##############.#########################..........#######.#.#.###############............########
##.##########........................................#######.#.#.###############..............######
##.##########.###.#########################..........#######.....###############..............######
##.##########.###.#########################..........#########...#############................######
##.##########.###.#########################..........#########.###############................######
##.##########.###.#############........#######################.###############................######
##........###.###.#############........#######################.###############................######
##........###.###.#############............###################.###############................######
###.......###.###.#############............#####.........#####.###############................######
###.........#.###..........................#####...............######........#................######
###.........#.#################............#####.........############........#................######
###.........#.###################..........#####.........############........#.................#####
###.........#.##.........########..........#####.........############........#.................#####
###.........#.##.........########..........#####.........############........#######...........#####
####........#............########..........#####.........############........#######...........#####
##########.#####.........########..........#####.........############........###...............#####
##########.#####.........########..........#####.........########..............................#####
##########....##.........########..........#####.........########.#######......................#####
#############.##.........###########################.############.#######......................#####
#############.##.........###########################.############.#######......................#####
#############.##.........###########################.###########...............................#####
#############.##.........###########################.#.........#...............................#####
#############.####.####............#################.#.........#............................########
#############.####.................#################.#.........#..........##.###............########
##########....#########............#################.#.........#..........##.####...........########
##########.############............#################...........#..........##.#######################
#######.........##.................##........####..............#..........##.#######################
#######.........##.................##........####.######.#######..........##.#######################
#######.........##.................##........####.##########################.#######################
#######.........#..................##.............##########################.#######################
#######.........#..................##........###############################.......#################
#######............................##........###############......###.........####.#################
#######.........#.................###..................#####......###.........####.#################
#######.........#.................###........#########.#####......#...........####.#################
#######.........#.................###........#########.#####..................####.#################
#########.......####.###..........###........#########.#####......#...........####.#################
#########.......####.###..........###......###########.#####......#...........####.#################
####################.###..........######.#############.#####......#.............................####
####################.###..........######.#############.#####......#...........##.......########.####
####################.###..........######.#############.############....................########.####
####################.###..........######.############..############...........##..................##
####################.###..........######.########......############.............................#.##
###################.............########.########......#########.............###.......##########.##
###################..########..........#.########......#########.............#####.##############.##
###################..########..........#.########......#########.............#####...############.##
#############..........######..........#.########......#########..................##.############.##
#############..........######..........#.########......#########...........######.##.############.##
#############..........######..........#.########......#########...........######......####.......##
###########............#######.........#.########......#########.......................####.########
###########.#..........#######.........#.########......#########...........########.........########
###########.#..........#######.........#.##########..............####.#.###########..#####..########
###########............#######.........#.############################.#.####.######..#####..########
#############..........#######.........#.################...#########................#####..########
#############..........#######.........#.......##########.#.###########..............#####..########
########################################.......##########.#.######................########..########
########################################.......##########.........................########..########
########################################..........................................########...#######
########################################.......############.#.....................#########......###
##############################.#########.......#######........###.................########.......###
########################..........######.......#######........###.................########.##.######
########################..........######.......#######........###.................########.##......#
########################..........###########.................###.................####......######.#
########################..........###########.########........####..........####..####......######.#
#############.....................###########.########........####..........####..####......######.#
#############.......####......................########........####..........####..#................#
#############.......##################################........#############.####............########
#############.......##################################........#############.#####.#.##......########
#############.......####################################.##################.#####.#.##......########
#############.......####################################....................#####.#.#.......########
#################################################################################.#.#.......########
#################################################################################.#.#.##.###########
#################################################################################.....##.###########
###################################################################################.####.###########
###################################################################################.####.###########
###################################################################################......###########
####################################################################################################
####################################################################################################
####################################################################################################
