################################################################
################################################################
#############.......................................############
#############.......##########################........##########
#############......###########################........##########
#############.............####################........##########
#############......######.####################........##########
#############......#####..####################........##########
#############......#####.####################.........##########
#############......#####.####################.........##########
##########........######.####################.#######.##########
##########..................#################.#######.##########
##########...........###....#################.#######.##########
##########...........########################.........##########
##########............#######################..#################
##########............#####....#######.........#################
##########.....................#######..#.####.#################
##########......................................################
#######...............#.###....#######..#.......################
#######...............#.###....#######..#.......################
#######..........####.#.###....#######..#.......################
#######..........####.#.###....#######..#.......################
#######..........####...##############..#............###########
#######..........#####################..#............###########
############.......###################..###..........###########
##########.........###################..###..........###########
##########.........###################..###..........###########
##########.........##################.......####################
##########.........##################.......####################
##########.........##################.......####################
#####################################..........#################
################...............................#################
################.####################..........#################
################..........###########..........#################
################..........###########..........#....############
#####..........#..........###########..........#....############
#####.....................###########.###......#....############
#####..........#..........###########.###......#....############
#####..........#..........###########.###......#....############
#####..........#######.##############.###......#....############
#####..........#######.##############....#######....############
#####......###########.#################............############
#####......#####..........##############.........###############
#####......#####..........##############.........###############
#####......#####..........##############.........###############
#########.######..........##############.........###############
########..######..........###......#####.........###############
########.#######..........###......##########.##################
########.#######...................##########.##################
########.#######...................##########.##################
########.#######...................########....#################
########.........########..........########....#################
#########################..........########....#################
#########################...........#######....#################
##############################......############################
##############################......############################
##############################......############################
##############################......############################
##############################......############################
##############################......############################
##############################......############################
##############################......############################
##############################......############################
################################################################
