################################################################
#######################.########################################
#######################.########################################
#######################.########################################
#######################.########################################
#######################.########################################
#######################.########################################
#######################.########################################
#######################.########################################
#######################.########################################
#######################.########################################
#######################.###############################........#
####################.....##############################.########
####################.....##############################.########
####################.....##############################.########
####################.....##############################.########
####################.....#####################..........########
#################..............................#################
#################.##.....#######################################
#################.##.....#######################################
#################.##.....#######################################
#################.##.....#######################################
#################......#########################################
#################......#########################################
#################......########################....#############
#################......########################....#############
#################......########################....#############
##################.....########################....#############
##################.....########################....#############
##################.....########################....#######.....#
################.......########################....#######.#####
################.#.############################....#######.#####
################.#.############################....#######.#####
################.#.############################.##########.#####
################.#.############################.##.........#####
################.#.######.....#################.##.#############
################.#..........#.#######...................########
################.#..........#.#######.#########.##.####.########
################.#..........#.........#########.##.####.########
################.#..........########............##.####.########
#####.........##............########.............#.####.########
#####.........####..........########..........##.#.####.########
#####.........####..........########..........##.#.####.########
#####.........####..........########...............####.########
#######.#.###.####..........########..........##.######.########
#######.#.###.####.###.#############..........##.######.########
#######.#.###.####.###.#############...........................#
#######.#.###.####.##........#######..........#########.######.#
#######.#.###.####...........########........##########.######.#
#######.#.....####...........########........##########.######.#
#######.####..####...........########........##########.######.#
#######.####..####...........##########....############.######.#
#######.####..####...........##########################.######.#
#######.####..####...........##########################.######.#
#######.####..####...........#######....###############.######.#
#######.####............................###############.######.#
#######.####.#####..###.############....###############.#......#
####...........###..###.############....##############....######
####.##.####.#.###..###.############....##############....######
####.##.####.#.###..###.############....##############....######
####.##.####.#.###..###.############....################..######
####................###.########################################
#####.#.######.####.###.########################################
################################################################
