################################################################
###################################.############################
###################################.#####......#################
###################################.####.......#################
###################################.####.......#################
###################################.####.......#################
###################################.####.......#################
###################################.####.......#################
###################################.####.......#################
###################################.####.......#################
###################################.####.#######################
###################################.####.##############...###..#
###################################.####.##############.#.###.##
###################################.####.##############.#.###.##
###################################.####.##############.#.###.##
######################................##.##############.#.###.##
######################.#######..###.#.##.##############........#
######################.#...............#.##################.#..#
######################...######........#.#################.....#
#........###########.....######........#...###############..#.##
#........##............................###.###############..#.##
#........##............................###.###############..#.##
#........##............................###.###############..#.##
#........##....................####.######.###############..#.##
###.#######....................####.######.###############..#.##
###.#######....................####.######..................#.##
###.#######..........###.####..####.#######################.#.##
###.########.......#.###.......####.#######################...##
###.########.......#.###.#####.####.#######################.####
###.########................................................####
###.########.......#.###.######........####################.####
###.########.......#...............###.####################.####
###.########.......#####.######.######.####################.####
#...########.......#####.######.######.######....##########.####
############.......#####.######.######.######....##########.####
########################.######.######.######....##########.####
########################.######...............................##
########################.######.###.#########....###..##.##.#.##
########################.######.###.#########....###..##.##...##
#..........#############.######.###.#########....###..##.#######
##########.#############.######.###.#########....###.....#######
##########.#############.######.###.################.###.#######
##########.#############.######.###.################.###.#######
##########.#.........###.######.###.################.###.#######
##########.#.........###.####..........#############.###.#######
##########.#.........###.####.#.###....#############.###.#######
##########...........###.####.#.#......................#.#######
##########...........###.####.#........###############.#.#######
##########...........###.####.#........###############.#.#######
##########...........###...............###############.#.#######
##########..###############.#########..###############.#.#######
#########......############.#########..###############.#.......#
#########......############.#########..###############.#########
######.........############.#########..#############........####
######.##......############.#########..#############........####
######.##......############.#########..#############........####
######.##......############.#########..#############........####
######.##......................................#####........####
######.####.###############.......................##........####
######.####.#########################..#######.##.##........####
######.####.#########################..#######.##.##........####
#####..####...................#######..........##.##........####
#####.#######################.#######.###########.##........####
################################################################
