################################################################
#.........#################....######.##########################
##.######.#################....######.##########################
##.######.#################....######.##########################
##.######.#################....######.##########################
##.######.#################....######.##########################
##.######.#################...........##################.......#
##.............................################..........#######
##############..........###............########.################
##############..........###.....................################
##############..........######.........#######..################
##############..........######.........#######...#..........####
##############################.........########..#..#####......#
###############################################.........####.###
###......######################################..##.###.####.###
###......#####################..........#######................#
###......#####################.......................##.##....##
###......#####################.............###...##..##.##.#..##
###......#####################.............###.####..##.##.#####
###.......................####.............###.####..##.##.#####
#######..################.####.............###.####..##.##.#####
#######..################.####.............###.####..##.##.#####
#######..################.##########.......###.####..##.##.#####
#######..################.#......................##..##.##.#####
########.################.#.#####..........###.#.##..##.##.#####
########.################.#.#####.......######.#.##..##.##.#####
########.###############.....####.......######.#.##..##.##.#####
########.###############.......................#.##..........###
########.###############.....####..............#.##............#
########.###############..............#........#...............#
########.########............#####.####........#####...........#
########.########.######.....#####.####........#####...........#
########.#######.......#.....#####.####...........##...........#
########.....................#####.####........................#
########.#######.......#.....#####.##############..............#
########.#######.......#...........##############.....#.##.#####
########.#######.......##.###..##################............###
########.#######.......##.####.##################............###
########.#######..........####.################............#####
########.#######...............################.##.........#####
########.#########..####.####..################............#####
########.######..........####..#######.....................#####
########.######.##.####........#######.###########.........#####
########.######.......##.#####.#######.##......###.........#####
########.######.......##.......................#################
########.######................................#################
########..............###......................#################
########...............##..................#####################
########...............#####...................#################
########...............#####...................#################
########.......................................#################
########.#.##..........#####...................#################
########.#.##..........#####.........#.........#################
########.#.##..........#####.........#.........#################
########.#.##..........###############.........#################
#..........##..........#########################################
########.####..........#########################################
########.......#################################################
#############..#################################################
#############..#################################################
#############..#################################################
#############....###############################################
##############.#.###############################################
################################################################
