################################################################
####################.#.###.########.##########################.#
####################.#.###.########.##########################.#
##########...#####......##............########################.#
##########.#.#####.#....######...............#################.#
##########.#.#####.#.........#.......#######...................#
##########.#.#####.#.................#######..##################
#########............................##........#################
########.............................##........#################
########........................#.....................##########
##........................#######..##..................#########
##........................#######..#.........................###
##.....................................................#####.###
##.........................######..##..................#####.###
##.........................######..............#############.###
##................########.........##..........#############.###
######.#..........########.........##.........##############.###
######.###.###############....................##############.###
######.###.###############....................##############...#
######.###.###############.#..................##################
######.###......##########.#.........................###########
######.###..#.........####.#.........####.##..........##########
######.###..#.........................................##########
###.....##..#........................#######..............######
###.#.......#.................####.####........................#
#.......###.#.................####.####.####...............#####
#.............................####.####.####.................###
#.......##.##.................####.####.######.#############.###
#.................###.........####.####.######.#############.###
#............................#####......######.#####.......#.###
##.####.............#......###################.#####.......#.###
##.####...............#############........###.#####.......#.###
##.######..#..........#############........###.#####.......#.###
#.....................#############........###...............###
##.####.#..#..........#############........###.#####.......#####
##.##.................#############........###....##.......#####
##.##.#.#..#..........#############...............#####..#.#####
##.##.#.##.#..........#############..........#....#####..#.#####
##.##.#.##.#..........#############..........#....#####..#.#####
##.##......#..........#############..........#....#####..#.#####
##.####......................................#...........#.#####
##.##########..######.#############.####.#.###....#####..#.#####
##.##########..######.#############.####...................#####
#..##########..######.#############.######......#...############
#############..######....##########.######.######.#..........###
#############..######..#.##########.######.######.#..........###
#############..######..#.##########.######.######.#..........###
#############..######..#.##########.######.######.#..........###
#############..######..#.##########.######.######.#..........###
#############..###.........########.######.######.#............#
#############..###.........########.######..................####
#############....................##.######.######.##############
#####....####.##...........#####...............##.##############
#####....####.##...........########.######.###.............#####
#####.........##...........########.######.###..#.########.#####
#####....#######..........#########.######.###..#.#.........####
#####....#######..........#########.............#.#.######..####
#####....#######..........#########.######......#.#.######..####
#####....#######....................##########.##.#.######..####
#####....############.##........###.........................####
#####....#######......#########.##############.##.#.######.#####
################.####.#########.##############......######.#####
################.####.#########.##############....########.#####
################################################################
