################################################################
############.......###................########.#################
#####.........####.###.........................#################
#####.#######.####.#####.####....##.........#..........#########
##....#######.####.#####.####....##.........#..........#########
#.....#######.####.#####.####....##.........#..........#########
##.##.#######.####.#####.##............................#########
##.##.#######.####.####................................#########
##.##.#######......................................#############
##.##.#.....#......................................#############
##....#.....#...............................####################
#######.....#...............#...............####################
#######.....#...............#........#......####################
#######.....#...........###.#........#.#########################
#######.................###.#................###################
#######.................###.#.#......#.#####.####........#######
########.................##.#.#......#.#........#........#######
########.................##...##.#####.#........#........#######
########.................##.####.#####.#.................#######
########.................##.####.#####.#..............##########
########...........########.####.#####.#..............##########
############.......########.####......................##########
##################.########.##########..#.............##########
##################.########.###########...............##########
##################.########.############..................######
##################.########.############..................######
##################.########.############.###..............######
##################.########.......######.###..............######
##################.########.....#.######.###..............######
###........#######.###........#.#.........................######
###..............#.###........#.########.##########.......######
###................###........#.########.##########.......######
###..............#####..........########.#######################
###..............#####........##########.###########..........##
###..................#........##########.##########...........##
###.####......................##########.##########...........##
###.####......................#########..##########...........##
###.####....................##................................##
###.####....##..............##..........###########...........##
###.####....##..............##..........###########...........##
###.####....##............##............############..........##
###.####.....#.....###....##............############..........##
###.####.....#............##............########################
###.#######..#............##............########################
###.#######..#............##............########################
###.#######..#............##............########################
###.#######..#............####..........###########..........###
###.#######.................########..............#..........###
###.#######.##.........####.##############........#..........###
##........#.......................########........#..........###
##........########................########...................###
##........########....................####...................###
##........########....................####...................###
#############.........................#########.#............###
#############.........................###########............###
#############......................##############............###
#############...............#......##############........#######
#############...............#......##############........#######
#############...............#......##############........#######
#############...........#####......#############################
############............#####......#############################
############.################......#############################
############.################......#############################
################################################################
