################################################################
###########..........#..............#..#########################
###########.................#######.#..#########################
#######.....................#######.#..####################....#
#######.###.................#####......####################.####
#######.###.................#####.#.##.####################.####
#######.###.#.....................#.##........#############.####
#######.###.#...............####............................####
##...............###...###.##..........######.#######..#########
##.####................................######.####.....#########
#................###...................#....#.####.....#########
##.....................................#....#.####.....#########
#######..........###...................#....#..................#
#######..........###...................#........##.....#########
#######..........###..............######........##.....#########
#######...........................####..........##.....#########
#######...........##..............####.#........##.....#########
#######...........##..........###.####.#........##.....#########
#######.......................###.####.###########.....#########
#.....................#.##.######.####.########..........#######
####....................##.######.####.#######.................#
##.............#####.#####.######........................#######
##......##.....#####.#####.###########.#######...........#######
##......##.....#####.#####.###########.#######...........#######
##......##...........#####.###########.#######...........#######
##......##.....###########.##..........########..........#######
##......##.###############.##.#################..........#######
##......##.###..........##.##.###################........#######
##......##.###..........##.#..#####################......#######
##.........................#.######################......#######
##......##.###..........####......#################......#######
######..##..............####......................#......#######
######....................................#######.#......#######
#######.................####..............#######.#......#######
#######.##..............####.................####.##############
#######.##.######.##########.................####.##############
#######.##.######.#####...........................##.......#####
#######.##.######.#####...........................##.......#####
#######.##.######.#####...........................##.......#####
#####.........###.#####....................................#####
#.............###.##########.............................#######
#####.........###.##########.............................#######
#####.........###.########............##.................#######
##########.######.########............##.................#######
##########.######.########.....#########.................#######
##########.######.########.....###..................############
##########.######.########.....###.......####............#######
##########.######.########.....###.......####............#######
##########.######.#######......###.......########........#######
##########.######.#######......###.......###.............#######
##########.######.#######......###.......###.............#######
##########.##.......##.........###.......###.............#######
##########.##.......##.........###.......................#######
##########.##.......##.........###.......................#######
#...................##.........###.......................#######
##########.##.......##..................................########
##########.##.......##.........##########.......###.#.#.########
##########.##.......##.........##########.......###.#.#.########
##########.##.......##.........##########.......###.#.#.########
##########.##.......##.........##########.......###.#.#.########
##########.##.......##.........##########.......###.#.#....#####
##########.########.###############################.#.####.....#
##########.########.###############################.#.##########
################################################################
